# # # # # # # # # # # # # # #
# n 1 n 2 3 n n n n n n n 2 #
# n n n n n n 3 n n 1 n n 2 #
# n n n 2 n n n n n n n n n #
# n n 3 n n 3 n n n n n n n #
# n n n n n n n n 5 n n n n #
# n n n n n n n n n n n n n #
# n n 3 n n 3 n n n n n n n #
# n n n n n n n n 5 n n n n #
# n n n n n n n n n n n n n #
# n n 3 n n 3 n n n n n n n #
# n n n n n n n n 5 n n n n #
# n n n n n n n n n n n n n #